1111111111111111111
100000010C000E00001
100P000100000000001
10000001H0100001111
100000000010C000001
1000000000100000001
1H00C00000100C000C1
1111111111111111111